F 30,30,30
C 60,60,60

NO ./textures/north.xpm
SO ./textures/south.xpm
WE ./textures/west.xpm
EA ./textures/east.xpm

1111111111111111111
1001001001001001001
1001001001001001001
1001001001001001001
1001001000001001001zz
100000000S000000001
1000011111111000001
1111000000000001111
1000000101010000001
1111111111111111111

